11111111111111111111111111111
1111000C11111000P111111C00001
11100111111100000001111110001
1100000011100000000C111000111
1C000000111000P00111111100001
111100000C0000000011111110001
111111111110E00C00011110000C1
10000CC0111000111000111000111
1P0C00001100000000000C0000001
1111000011E0000C0000111111111
111110E01110001110001110000C1
11111100111000000000111000111
111111100C00000E00000C0000111
11111111111111111111111111111