11111111111111111111111111
1111000C111110001111111C00001
11100111111100000
1100000011100000000C111000111
1C000000111000000111111100001
111
111111111110000C00011110000C1
10000000111000111000111000111
1P0C00001100000000000C000
1111000011000
111110001110001110001110000C1
1111110011100000000
111111100C00000E00000C0000111
1111111111111111111111111111