11111111111111111111111111111
11110000111110001111111000001
11100111111100000001111111101
11000000111000000000111000001
10000000111000100111111100001
11110000000000000011111110001
11111111111000000001111000001
10000000111000111000111000111
11000000110000000000000000001
11110000110000000000111111111
11111000111000111000111000001
111111001110000P0000111000111
11111110000000CEC000000001111
11111111111111111111111111111
