11111111111111111111111
11110000110001111100001
11000011100000001111001
10000000100000111110001
11110000000000011110111
11111110000000011100001
10000011000111001100111
1P000001100000000000001
11110000100000001111111
11111000000111001100001
11111100000000001000111
111111100000E0000001111
11111111111111111111111
