1111111111111111111111111111111111111111111111111111111111111111111111111111111111111111111111111111111111111111111111111
1111000110001111111000111111111111111111111111111111111111111111111111111111111111111111111111111111111111111111111111111
1100001110000001111100111111111111111111111111111111111111111111111111111111111111111111111111111111111111111111111111111
1101000010000011111001111111111111111111111111111111111100001111111111111111111100001111111111111111111111111111111111011
1111C10000000001111011111111111111111111111111111111111100001111111111111111111100001111111111111111111111111111111111111
1111111000001001110001111111111111111111111111111111111100001111111111111111111100001111111111111111111111111111111111111
1000011000111001100111111111111111111111111111111111111100001111111111111111111100001111111111111111111111111111111111111
1P11000110000000100000111111111111111111111111111111111100001111111111111111111100001111111111111111111111111111111111111
1111010010001000111111111111111111111111111111111111111100001111111111111111111100001111111111111111111111111111111111111
1111100000011100110001111111111111111111111111111111111100001111111111111111111100001111111111111111111111111111111111111
1111110000000000100011111111111111111111111111111111111100000000000000000000000000001111111111111111111111111111111111111
111111101000E000100111111111111111111111111111111111111100000000000000000000000000001111111111111111111111111111111111111
1111111111001001111111111111111111111111111111111111111100001111111111111111111100001111111111111111111111111111111111111
1111111111000001111111111111111111111111111111111111111100001111111111111111111100001111111111111111111111111111111111111
1111111111000001111111111111111111111111111111111111111100001111111111111111111100001111111111111111111111111111111111111
1111111111000001111111111111111111111111111111111111111100001111111111111111111100001111111111111111111111111111111111111
1111111111000001111111111111111111111111111111111111111100001111111111111111111100001111111111111111111111111111111111111
1111111111000001111111111111111111111111111111111111111100001111111111111111111100001111111111111111111111111111111111111
1111111111000001111111111111111111111111111111111111111100001111111111111111111100001111111111111111111111111111111111111
1111111111000001111111111111111111111111111111111111111100001111111111111111111100001111111111111111111111111111111111111
1000000000000000000000000000000000000001111111111111111100001111111111111111111100001111111111111111111111111111111111111
1000000000000000000000000000000000000011111111111111111111111111111111111111111111111111111111111111111111111111111111111
1000000111111111000111111111111111000011111111111111111111111111111111111111111111111111111111111111111111111111111111111
1000001111110011111111111001111111111111111111111111111111111111111111111111111111111111111111111111111111111111111111111
1111111111111111111111111111111111111111111111111111111100000000000000000000000000001111111111111111111111111111111111111
1000111111110011111110000011111011111111111111111111111100000000000000000000000000001111111111111111111111111111111111111
1001111011110000000000000011111011111111111111111111111111111111111100001111111111111111111111111111111111111111111111111
1011110011110000000000000011111011111111111111111111111111111111111100001111111111111111111111111111111111111111111111111
1111100011110000000000011111110011111111111111111111111111111111111100001111111111111111111111111111111111111111111111111
1111111111111100001111111111000111111111111111111111111111111111111100001111111111111111111111111111111111111111111111111
1111111111001111111110000011111111111111111111111111111111111111111100001111111111111111111111111111111111111111111111111
1111111111111111011111111100000000111111111111111111111111111111111100001111111111111111111111111111111111111111111111111
1000000000111100111110000000000000111111111111111111111111111111111100001111111111111111111111111111111111111111111111111
1000000000111100111110000000000000111111111111111111111111111111111100001111111111111111111111111111111111111111111111111
1000000000111100111110000000111111111111111111111111111111111111111100001111111111111111111111111111111111111111111111111
1000000011111111111111111111111111111111111111111111111111111111111100001111111111111111111111111111111111111111111111111
1000000011111111111111111111111111111111111111111111111111111111111100001111111111111111111111111111111111111111111111111
1000000011111111111111111111111111111111111111111111111111111111111100001111111111111111111111111111111111111111111111111
1000000000000000000000000000000000000011111111111111111111111111111100001111111111111111111111111111111111111111111111111
1000000000000000000000000000000000000011111111111111111100000000000000000000000000001111111111111111111111111111111111111
1000111111110011111110000011111011111111111111111111111100000000000000000000000000001111111111111111111111111111111111111
1000000000000000000000000000000000000011111111111111111111111111111111111111111111111111111111111111111111111111111111111
1000000000000000000000000000000000000011111111111111111111111111111111111111111111111111111111111111111111111111111111111
1000000000000000000000000000000000000011111111111111111111111111111111111111111111111111111111111111111111111111111111111
1000000000000000000000000000000000000011111111111111111111111111111111111111111111111111111111111111111111111111111111111
1000000000000000000000000000000000000011111111111111111111111111111111111111111111111111111111111111111111111111111111111
1111111111111111111111111111111111111111111111111111111111111111111111111111111111111111111111111111111111111111111111111
1111111111111111111111111111111111111111111111111111111111111111111111111111111111111111111111111111111111111111111111111
1111111111111111111111111111111111111111111111111111111111111111111111111111111111111111111111111111111111111111111111111
1111111111111111111111111111111111111111111111111111111111111111111111111111111111111111111111111111111111111111111111111
1111111111111111111111111111111111111111111111111111111111111111111111111111111111111111111111111111111111111111111111111
1111111111111111111111111111111111111111111111111111111111111111111111111111111111111111111111111111111111111111111111111
1111111111111111111111111111111111111111111111111111111111111111111111111111111111111111111111111111111111111111111111111
1111111111111111111111111111111111111111111111111111111111111111111111111111111111111111111111111111111111111111111111111
1111111111111111111111111111111111111111111111111111111111111111111111111111111111111111111111111111111111111111111111111
1111111111111111111111111111111111111111111111111111111111111111111111111111111111111111111111111111111111111111111111111
1111111111111111111111111111111111111111111111111111111111111111111111111111111111111111111111111111111111111111111111111
1111111111111111111111111111111111111111111111111111111111111111111111111111111111111111111111111111111111111111111111111
1111111111111111111111111111111111111111111111111111111111111111111111111111111111111111111111111111111111111111111111111
1111111111111111111111111111111111111111111111111111111111111111111111111111111111111111111111111111111111111111111111111
1111111111111111111111111111111111111111111111111111111111111111111111111111111111111111111111111111111111111111111111111
1111111111111111111111111111111111111111111111111111111111111111111111111111111111111111111111111111111111111111111111111
1111111111111111111111111111111111111111111111111111111111111111111111111111111111111111111111111111111111111111111111111
