11111111111111111111111
1111000C1100011111C0001
110000111000000C1111001
1C0000001000001111100C1
11110000000000011110111
111111100000C00111000C1
10000011000111001100111
1PEC000110000000C000001
111100001000C0001111111
111110000001110011000C1
11111100000000001000111
11111110C000E000C001111
11111111111111111111111
