11111111111111111111111111111
1111000C111110001111111C00001
111001111Q1100000001111110001
1100000011100000000C111000111
1C000000111000000111111100001
111100000C0000000011111110001
111111111110000C00011110000C1
10000000111000111000111000111
1P0C00001100000000000C0000001
111100001100000C0000111111111
111110001110001110001110000C1
11111100111000000000111000111
111111100C00000E00000C0000111
11111111111111111111111111111