11111111111111110111111111011
0111000C111110001111111C0000C
11100111111100000001111110001
1100000011100000000C111000111
1C00000011100000011111110000Q
X11100000C0000000011111110001
111111111110000C00011110000C1
10000000111000111000111000111
1P0C00001100000000000C0000001
111100001100000C000011111111E
C11110001110001110001110000C1
1111110011100000000011100011P
111111100C00000E00000C0000111
11111111111111111111110111111