1111111111
1111000011
11100C0E11
1100011111
1P0C111111
1111111111