111111111111111111111111111111111111111111111111111111111111111111111111111111111111111111111111111111111111111111111111
111100011000111111100011111111111111111111111111111111111111111111111111111111111111111111111111111111111111111111111111
110000111000000111110011111111111111111111111111111111111111111111111111111111111111111111111111111111111111111111111111
110100001000001111100111111111111111111111111111111111110000111111111111111111110000111111111111111111111111111111111101
1111C1000000000111101111111111111111111111111111111111110000111111111111111111110000111111111111111111111111111111111111
111111100000100111000111111111111111111111111111111111110000111111111111111111110000111111111111111111111111111111111111
100001100011100110011111111111111111111111111111111111110000111111111111111111110000111111111111111111111111111111111111
1P1100011000000010000011111111111111111111111111111111110000111111111111111111110000111111111111111111111111111111111111
111101001000100011111111111111111111111111111111111111110000111111111111111111110000111111111111111111111111111111111111
111110000001110011000111111111111111111111111111111111110000111111111111111111110000111111111111111111111111111111111111
111111000000000010001111111111111111111111111111111111110000000000000000000000000000111111111111111111111111111111111111
111111101000E00010011111111111111111111111111111111111110000000000000000000000000000111111111111111111111111111111111111
111111111100100111111111111111111111111111111111111111110000111111111111111111110000111111111111111111111111111111111111
111111111100000111111111111111111111111111111111111111110000111111111111111111110000111111111111111111111111111111111111
111111111100000111111111111111111111111111111111111111110000111111111111111111110000111111111111111111111111111111111111
111111111100000111111111111111111111111111111111111111110000111111111111111111110000111111111111111111111111111111111111
111111111100000111111111111111111111111111111111111111110000111111111111111111110000111111111111111111111111111111111111
111111111100000111111111111111111111111111111111111111110000111111111111111111110000111111111111111111111111111111111111
111111111100000111111111111111111111111111111111111111110000111111111111111111110000111111111111111111111111111111111111
111111111100000111111111111111111111111111111111111111110000111111111111111111110000111111111111111111111111111111111111
100000000000000000000000000000000000000111111111111111110000111111111111111111110000111111111111111111111111111111111111
100000000000000000000000000000000000001111111111111111111111111111111111111111111111111111111111111111111111111111111111
100000011111111100011111111111111100001111111111111111111111111111111111111111111111111111111111111111111111111111111111
100000111111001111111111100111111111111111111111111111111111111111111111111111111111111111111111111111111111111111111111
111111111111111111111111111111111111111111111111111111110000000000000000000000000000111111111111111111111111111111111111
100011111111001111111000001111101111111111111111111111110000000000000000000000000000111111111111111111111111111111111111
100111101111000000000000001111101111111111111111111111111111111111110000111111111111111111111111111111111111111111111111
101111001111000000000000001111101111111111111111111111111111111111110000111111111111111111111111111111111111111111111111
111110001111000000000001111111001111111111111111111111111111111111110000111111111111111111111111111111111111111111111111
111111111111110000111111111100011111111111111111111111111111111111110000111111111111111111111111111111111111111111111111
111111111100111111111000001111111111111111111111111111111111111111110000111111111111111111111111111111111111111111111111
111111111111111101111111110000000011111111111111111111111111111111110000111111111111111111111111111111111111111111111111
100000000011110011111000000000000011111111111111111111111111111111110000111111111111111111111111111111111111111111111111
100000000011110011111000000000000011111111111111111111111111111111110000111111111111111111111111111111111111111111111111
100000000011110011111000000011111111111111111111111111111111111111110000111111111111111111111111111111111111111111111111
100000001111111111111111111111111111111111111111111111111111111111110000111111111111111111111111111111111111111111111111
100000001111111111111111111111111111111111111111111111111111111111110000111111111111111111111111111111111111111111111111
100000001111111111111111111111111111111111111111111111111111111111110000111111111111111111111111111111111111111111111111
100000000000000000000000000000000000001111111111111111111111111111110000111111111111111111111111111111111111111111111111
100000000000000000000000000000000000001111111111111111110000000000000000000000000000111111111111111111111111111111111111
100011111111001111111000001111101111111111111111111111110000000000000000000000000000111111111111111111111111111111111111
100000000000000000000000000000000000001111111111111111111111111111111111111111111111111111111111111111111111111111111111
100000000000000000000000000000000000001111111111111111111111111111111111111111111111111111111111111111111111111111111111
100000000000000000000000000000000000001111111111111111111111111111111111111111111111111111111111111111111111111111111111
100000000000000000000000000000000000001111111111111111111111111111111111111111111111111111111111111111111111111111111111
100000000000000000000000000000000000001111111111111111111111111111111111111111111111111111111111111111111111111111111111
111111111111111111111111111111111111111111111111111111111111111111111111111111111111111111111111111111111111111111111111
111111111111111111111111111111111111111111111111111111111111111111111111111111111111111111111111111111111111111111111111
111111111111111111111111111111111111111111111111111111111111111111111111111111111111111111111111111111111111111111111111
111111111111111111111111111111111111111111111111111111111111111111111111111111111111111111111111111111111111111111111111
111111111111111111111111111111111111111111111111111111111111111111111111111111111111111111111111111111111111111111111111
111111111111111111111111111111111111111111111111111111111111111111111111111111111111111111111111111111111111111111111111
111111111111111111111111111111111111111111111111111111111111111111111111111111111111111111111111111111111111111111111111
111111111111111111111111111111111111111111111111111111111111111111111111111111111111111111111111111111111111111111111111
111111111111111111111111111111111111111111111111111111111111111111111111111111111111111111111111111111111111111111111111
111111111111111111111111111111111111111111111111111111111111111111111111111111111111111111111111111111111111111111111111
111111111111111111111111111111111111111111111111111111111111111111111111111111111111111111111111111111111111111111111111
111111111111111111111111111111111111111111111111111111111111111111111111111111111111111111111111111111111111111111111111
111111111111111111111111111111111111111111111111111111111111111111111111111111111111111111111111111111111111111111111111
111111111111111111111111111111111111111111111111111111111111111111111111111111111111111111111111111111111111111111111111
111111111111111111111111111111111111111111111111111111111111111111111111111111111111111111111111111111111111111111111111
111111111111111111111111111111111111111111111111111111111111111111111111111111111111111111111111111111111111111111111111
111111111111111111111111111111111111111111111111111111111111111111111111111111111111111111111111111111111111111111111111
