1111111111111111
1000000000000001
1000P10000111001
111C0000001C0001
11111111111E0001
1C00000000000011
1111111111111111