11111111111
10000111111
1CC11111101
110P11111E1
11100000001
11111111111